Salmonellenenteritis => Arizona-Enteritis
Botulismus => Botulinus-Intoxikation,Botulismus
Balantidiose => Balantidiasis,Balantidienruhr,Balantidiose
Kryptosporidiose => Kryptosporidiose
Isosporose => Isosporiasis,Isosporose,Kokzidien-Infektion,Kokzidiose
Bubonenpest => Beulenpest,Bubonenpest
Hautpest => Hautpest
Lungenpest => Lungenpest,Pestpneumonie
Pestmeningitis => Pestmeningitis
Pestsepsis => Pestsepsis
Hautmilzbrand => Hautmilzbrand,Milzbrand-Karbunkel
Lungenmilzbrand => Hadern-Krankheit,Anthrax-Pneumonie,Inhalations-Anthrax,Inhalationsmilzbrand,Lungenmilzbrand
Darmmilzbrand => Darmmilzbrand
Milzbrandsepsis => Anthrax-Sepsis,Milzbrand-Sepsis
Rotz => Maliasmus,Malleus,Rotz
Spirillen-Rattenbisskrankheit => Sodoku
Streptobazillen-Rattenbisskrankheit => Haverhill-Fieber
Haut-Erysipeloid => Hauterysipeloid,Rosenbach-Erysipeloid,Schweinerotlauf
Pasteurellose => Pasteurellose
Katzenkratzkrankheit => Debré-Syndrom,Inokulationsadenitis,Katzenkratz-Fieber,Katzenkratz-Krankheit,Katzenkratz-Syndrom,Kratz-Lymphadenitis,Petzetakis-Krankheit,Pneumo-lymphonodal-Syndrom
Borderline-Lepra => Borderline-Aussatz
Rachendiphtherie => Pharynxdiphtherie,Rachenbräune,Rachendiphtherie,Tonsillendiphtherie
Nasenrachendiphtherie => Nasenrachendiphtherie
Kehlkopfdiphtherie => Diphtherie-Laryngitis,Kehlkopfdiphtherie,Larynxdiphtherie
Hautdiphtherie => Hautdiphtherie,Nabeldiphtherie,Wunddiphtherie
Scharlach => Scarlatina,Scharlach,Scharlach-Albuminurie,Scharlach-Angina,Scharlach-Exanthem,Scharlach-Fieber,Scharlachkomplikation,Scharlach-Meningitis,Scharlach-Otitis,Scharlach-Cholangitis,Scharlach-Nephritis
Waterhouse-Friderichsen-Syndrom {E35.1} => Waterhouse-Friderichsen-Krankheit,Waterhouse-Friderichsen-Syndrom
Gonokokkenpharyngitis => Pharynxgonorrhoe,Rachenhöhlengonorrhoe
Gangosa => Gangosa
Lyme-Krankheit => Bannwarth-Krankheit,Lyme-Borreliose,Lyme-Krankheit,Neuroborreliose
Chlamydienkonjunktivitis {H13.1} => Einschlussblennorrhoe,Einschlusskonjunktivitis,Einschlusskörperchenkonjunktivitis,Paratrachom
Q-Fieber => Balkanfieber,Derrick-Burnet-Krankheit,Euboea-Fieber,Mossmann-Krankheit,Q-Fieber,Query-Fieber,Schlachthaus-Fieber,Kretapneumonie
Creutzfeldt-Jakob-Krankheit => Creutzfeldt-Jakob-Krankheit,Creutzfeldt-Jakob-Syndrom,Heidenhain-Syndrom
Wildtier-Tollwut => Wildtier-Rabies,Wildtier-Tollwut
Haustier-Tollwut => Haustier-Rabies,Haustier-Tollwut
Rocio-Virusenzephalitis => Rocio-Virusenzephalitis
Chikungunya-Viruskrankheit => Chikungunya-Fieber,Chikungunya-Viruskrankheit
O'Nyong-nyong-Fieber => O'Nyong-nyong-Fieber
West-Nil-Virusinfektion => West-Nil-Fieber,West-Nil-Virusinfektion
Rifttalfieber => Rift-Tal-Fieber,Rift-Valley-Fieber
Oropouche-Viruskrankheit => Oropouche-Fieber,Oropouche-Viruskrankheit
Pappataci-Fieber => Chitral-Fieber,Dalmatien-Fieber,Hunds-Fieber,Moskito-Fieber,Papatasi-Fieber,Pappataci-Fieber,Phlebotomus-Fieber,Pick-Fieber,Sandfliegen-Fieber
Colorado-Zeckenfieber => Colorado-Zeckenfieber
Buschgelbfieber => Buschgelbfieber,Dschungelgelbfieber
Lassa-Fieber => Lassa-Fieber
Kyasanur-Wald-Krankheit => Kumaon-Fieber,Kyasanur-forest-disease,Kyasanur-forest-Krankheit,Kyasanur-Wald-Fieber,Kyasanur-Wald-Krankheit
Marburg-Viruskrankheit => Marburg-Viruskrankheit
Ebola-Viruskrankheit => Ebola-Viruskrankheit
Varizellen-Meningitis {G02.0} => Varizellen-Meningitis
Varizellen-Enzephalitis {G05.1} => Varizellen-Enzephalitis,Varizellen-Enzephalomyelitis,Varizellen-Myelitis
Varizellen-Pneumonie {J17.1} => Varizellen-Pneumonie
Zoster-Enzephalitis {G05.1} => Zoster-Enzephalitis,Zoster-Enzephalomyelitis,Zoster-Meningoenzephalitis,Zoster-Myelitis
Zoster-Meningitis {G02.0} => Zoster-Meningitis
Pocken => Alastrim,Milchpocken,Paravariola,Pocken,Samoapocken,Sanagapocken,Variola,Varioloid,Variolois
Affenpocken => Affenpocken
Viruswarzen => Dornwarze,Fußsohlenwarze,Hautwarze,Lidverruca,Lidwarze,Palmarwarze,Plantarwarze,Verruca,Verrucae,Viruswarze,Warze
Mumps-Orchitis {N51.1} => Mumps-Orchitis
Mumps-Meningitis {G02.0} => Mumps-Meningitis
Mumps-Enzephalitis {G05.1} => Mumps-Enzephalitis,Mumps-Enzephalomyelitis,Mumps-Meningoenzephalitis,Mumps-Myelitis
Mumps-Pankreatitis {K87.1} => Mumps-Pankreatitis
Ross-River-Krankheit => Ross-River-Fieber,Ross-River-Krankheit
Candida-Stomatitis => Candida-Glossitis,Candida-Stomatitis,Mundkandidose,Mundmykose,Mundpilz,Mundschleimhautkandidose,Mundschleimhautsoor,Mundsoor,Oralsoor,Soorglossitis,Soorstomatitis,Stomatomykose
Candida-Meningitis {G02.1} => Candida-Meningitis,Soormeningitis
Candida-Endokarditis {I39.8} => Candida-Endokarditis
Candida-Sepsis => Candida-Sepsis,Soorsepsis
Candida-Ösophagitis => Candida-Ösophagitis,Soorösophagitis
Eumyzetom => Ascomycetes-Infektion,Deuteromycetes-Infektion,Eumyzetom,Maduramykose
Aktinomyzetom => Actinomadura-Infektion,Aktinomyzetom,Streptomykose
Lobomykose => Glenosporella-Infektion,Keloid-Blastomykose,Lobo-Krankheit,Lobomykose
Rhinosporidiose => Rhinosporidiose
Allescheriose => Allescheriose,Allescheriosis,Petriellidosis
Geotrichose => Geotrichose,Lungengeotrichose
Penizilliose => Penicilliosis,Penizilliose
Pneumozystose {J17.3} => Pneumocystis-Pneumonie,Pneumozystose,Pneumozystosis
Babesiose => Babesiose,Piroplasmose
Akanthamöbiasis => Akanthamöbiasis
Naegleriainfektion => Naegleriasis
Opisthorchiasis => Opisthorchiasis
Clonorchiasis => Clonorchiasis
Dicrocoeliasis => Dicrocoeliasis
Fascioliasis => Fascioliasis,Leberegel-Krankheit,Schafleberegel-Krankheit
Paragonimiasis => Lungenegelkrankheit,Paragonimiasis
Fasciolopsiasis => Darmegel-Krankheit,Fasciolopsiasis
Diphyllobothriose => Dibothriocephaliasis,Diphyllobothriasis,Diphyllobothriose
Sparganose => Sparganose,Spirometrose,Spirometrosis
Hymenolepiasis => Hymenolepiasis,Hymenolepis-Infektion
Dipylidiose => Dipylidiasis,Dipylidiose
Drakunkulose => Drakontiasis,Drakunkulose
Onchozerkose => Knoten-Filariasis,Onchozerkiasis,Onchozerkose,Roble-Krankheit,Flussblindheit
Loiasis => Kalabarbeule,Kalabarschwellung,Loa-loa-Filariose,Loa-loa-Infektion,Loiasis
Mansonelliasis => Acanthocheilonemiasis,Dipetalonemiasis,Filaria-ozzardi-Infektion,Mansonelliasis,Mansonellose
Trichinellose => Lungentrichinose,Orbitatrichinose,Trichinella-spiralis-Befall,Trichinella-spiralis-Infektion,Trichinelliasis,Trichinellose,Trichinose
Ankylostomiasis => Ancylostomiasis,Ankylostomiasis
Nekatoriasis => Nekatoriasis
Trichuriasis => Trichocephaliasis,Trichuriasis
Enterobiasis => Enterobiasis,Enterobiose,Fadenwürmer,Lungenoxyuriasis,Oxyuriasis
Anisakiasis => Anisakiasis,Anisakis-Larven-Befall
Trichostrongyliasis => Trichostrongyliasis
Gnathostomiasis => Gnathostomiasis
Syngamiasis => Syngamiasis,Syngamose,Syngamosis
Skabies => Borkenkrätze,Krätze,Räude,Skabies
Dermatomyiasis => Dermatomyiasis,Hautmadenfraß,Hautmyiasis
Wundmyiasis => Wundmyiasis
Ophthalmomyiasis => Orbitamyiasis,Augenmyiasis,Okulomyiasis,Ophthalmomyiasis
Otomyiasis => Otomyiasis
Lippenkommissur => Mundwinkelkarzinom,Mundwinkelkrebs
Zungenrücken => Zungenrückenkarzinom,Zungenrückenkrebs
Zungenrand => Zungenrandkarzinom,Zungenrandkrebs
Zungentonsille => Zungenmandelkrebs
Oberkieferzahnfleisch => Oberkieferalveolarfortsatzkarzinom,Oberkieferkarzinom
Unterkieferzahnfleisch => Mandibulakarzinom,Unterkieferkarzinom
Uvula => Uvulakarzinom,Uvulakrebs
Wangenschleimhaut => Mundschleimhautkarzinom,Mundschleimhautkrebs,Wangenschleimhautkarzinom,Wangenschleimhautkrebs
Kardia => Mageneingangskarzinom
Pylorus => Magenausgangskarzinom,Pyloruskarzinom,Pyloruskrebs
Duodenum => Duodenalkarzinom,Duodenalkrebs,Zwölffingerdarmkarzinom,Zwölffingerdarmkrebs
Jejunum => Jejunumkarzinom,Jejunumkrebs
Ileum => Ileumkarzinoid,Ileumkarzinom,Ileumkrebs
Zäkum => Ileozökalkarzinom
Leberzellkarzinom => Cholangiohepatom,Hepatocholangiokarzinom,Hepatokarzinom,Hepatom,Leberembryom,Leberzellkarzinom
Hepatoblastom => Hepatoblastom
Pankreaskopf => Pankreaskopfkarzinom,Pankreaskopfkrebs
Pankreasschwanz => Pankreasschwanzkarzinom
Milz => Milzkarzinom,Milzkrebs
Nasenhöhle => Nasenhöhlenkarzinom,Nasenhöhlenkrebs,Olfaktoriusneuroblastom,Olfaktoriusneuroepitheliom,Schneider-Karzinom,Ästhesioneuroblastom,Ästhesioneuroepitheliom,Ästhesioneurozytom
Mittelohr => Mittelohrkarzinom,Mittelohrkrebs
Glottis => Glottiskarzinom,Glottiskrebs,Stimmbandkarzinom,Stimmlippenkarzinom
Supraglottis => Supraglottiskrebs
Subglottis => Subglottiskrebs
Larynxknorpel => Kehlkopfknorpelkarzinom,Kehlkopfknorpelkrebs
Herz => Herzbeutelkarzinom,Herzkarzinom,Herzkrebs,Perikardkarzinom
Pleura => Pleurakarzinose
Maxillofazial => Maxillasarkom
Unterkieferknochen => Ameloblastosarkom,Amelosarkom,Kieferknochensarkom,Odontosarkom,Unterkieferknochensarkom,Unterkiefersarkom
Wirbelsäule => Wirbelkörpersarkom,Wirbelsarkom,Wirbelsäulenkrebs,Wirbelsäulensarkom
Rippen => Rippensarkom
Sternum => Brustbeinsarkom,Sternumsarkom
Klavikula => Klavikulasarkom,Schlüsselbeinsarkom
Beckenknochen => Kreuzbeinsarkom,Steißbeinsarkom
Lippenhaut => Lippenbasaliom,Lippenhautkarzinom,Lippenhautkrebs
Endozervix => Endozervixkarzinom
Ektozervix => Ektozervixkarzinom,Ektozervixkrebs
Endometrium => Endometriumkarzinom
Parametrium => Parametriumkarzinom,Parametriumkrebs
Samenstrang => Samenstrangkarzinom
Skrotum => Schornsteinfegerkrebs,Skrotumbasaliom,Skrotumkarzinom,Skrotumkrebs
Urachus => Urachuskarzinom,Urachuskrebs
Urethra => Harnröhrenkarzinom,Harnröhrenkrebs,Urethrakarzinom,Urethrakrebs,Urethramalignom
Konjunktiva => Bindehautkarzinom,Bindehautkrebs,Konjunktivakarzinom,Konjunktivakrebs
Kornea => Korneakarzinom,Korneakrebs
Retina => Netzhautastrozytom,Retinaastrozytom,Retinakarzinom,Retinakrebs,Retinoblastom,Retinogliom,Retinom
Chorioidea => Aderhautmelanom,Chorioideakarzinom,Chorioideakrebs
Ziliarkörper => Augapfelkarzinom,Augapfelkrebs,Uveaepitheliom
Orbita => Augenhöhlenkarzinom,Augenhöhlenkrebs,Orbitakarzinom,Orbitakrebs,Orbitasarkom
Hirnhäute => Hirnhautkrebs
Temporallappen => Temporallappenastrozytom
Hirnventrikel => Gehirnventrikelkarzinom,Gehirnventrikelkrebs
Zerebellum => Kleinhirngliom,Kleinhirnkarzinom,Kleinhirnkrebs,Medulloblastom,Medullomyoblastom,Zerebellarsarkom
Hirnstamm => Hirnstammgliom,Hirnstammkarzinom,Hirnstammkrebs
Rückenmark => Rückenmarkkarzinom,Rückenmarkkrebs
Nebennierenmark => Phäochromoblastom
Nebenschilddrüse => Epithelkörperchenkrebs,Nebenschilddrüsenkrebs
Hypophyse => Hypophysenkarzinom,Hypophysenkrebs,Hypophysenmalignom,Mukoidzelladenokarzinom,Mukoidzellkarzinom
Thorax => Axillakarzinom,Thoraxkarzinom,Thoraxkrebs
Abdomen => Abdomenkarzinom,Abdomenmalignom,Baucheingeweidekarzinom,Baucheingeweidemalignom,Bauchkarzinom,Bauchmalignom,Bauchraumkarzinom,Unterbauchkarzinom
Becken => Beckenkarzinom,Dammkarzinom,Leistenkarzinom,Unterleibkarzinom,Unterleibmalignom
Mantelzell-Lymphom => Mantelzell-Lymphom,Zentrozytom
Burkitt-Lymphom => Burkitt-like-Lymphom,Burkitt-Lymphom,Burkitt-Tumor,Burkitt-Tumor-Lymphom
Sézary-Syndrom => Sézary-Krankheit,Sézary-Retikulose,Sézary-Syndrom
Penis => Erythroplasie,Peniserythroplasie,Queyrat-Erythroplasie,Queyrat-Syndrom
Auge => Bindehauterythroplasie,Konjunktivaerythroplasie
Lippe => Lippenpapillom
Tonsille => Tonsillenpapillom
Parotis => Parotisadenom,Parotiszystadenolymphom
Zäkum => Zäkumadenom
Rektum => Rektumadenom
Ösophagus => Ösophagusadenom
Magen => Magenschleimhautadenom
Leber => Adenohepatom,Cholangiom,Hepatocholangiom,Leberadenom,Leberzelladenom
Pankreas => Bauchspeicheldrüsenadenom,Pankreasadenom
Larynx => Kehlkopfadenom,Larynxadenom,Larynxchondrom,Larynxmyom,Larynxmyxom,Larynxpapillomatose,Stimmbandleiomyom,Stimmbandmyom,Stimmbandpapillom
Trachea => Tracheaadenom,Tracheachondrom,Tracheafibrom,Tracheapapillom
Thymus => Thymoblastom,Thymom,Thymusepitheliom
Herz => Herzmyom,Vorhofmyxom
Maxillofazial => Cementoma,Nasenosteom,Oberkieferadamantinom,Oberkieferadenoameloblastom,Oberkieferameloblastenfibrom,Zementom
Unterkieferknochen => Adamantinoblastom,Adamantinom,Adenoameloblastom,Ameloblastenfibrom,Ameloblastom,Ameloblastoodontom,Cementoblastoma,Dentinoblastom,Dentinom,Keratozyste,Odontoameloblastom,Odontom,Zementoblastom
Peritoneum => Peritonealmyxom
Vulva => Vulvapapillom
Vagina => Vaginalfibrom
Prostata => Blasenhalsadenom,Harnblasenhalsadenom,Prostataadenofibrom,Prostataadenom,Prostataadenomyom,Prostatafibroadenom,Prostatafibrom,Prostatalappenadenom,Prostataleiomyom,Prostatamyoadenom,Prostatamyom,Prostatapapillom,Prostatarhabdomyom
Nebenhoden => Nebenhodenkopffibrom
Niere => Nierenadenom,Nierenkapseladenom,Nierenrindenadenom,Nierenrindenpapillom
Nierenbecken => Nierenbeckenpolyp
Harnblase => Blasenadenom,Harnblasenadenom
Urethra => Urethrapapillom
Konjunktiva => Bindehautdermoid,Bindehautfibrom,Bindehautnävus,Bindehautpapillom,Konjunktivadermoid,Konjunktivafibrom,Konjunktivapapillom
Chorioidea => Aderhautnävus
Ziliarkörper => Irisnävus,Ziliarkörpermelanozytom
Hirnhäute => Klivusmeningeom,Optikusmeningeom,Orbitameningeom,Sehnervmeningeom,Tentoriummeningeom
Hirnnerven => Akustikusneurilemmom,Akustikusneurinom,Akustikusneurom,Optikusgliom
Nebenniere => Nebennierenadenom,Nebennierenparagangliom,Phäochromozytom
Nebenschilddrüse => Epithelkörperchenadenom,Hauptzelladenom,Nebenschilddrüsenadenom,Parathyreoideaadenom
Hypophyse => Hypophysenadenom,Makroprolaktinomsyndrom,Mukoidzelladenom,Prolaktinom
Lymphknoten => Castleman-Krankheit,Castleman-Lymphom,Castleman-Syndrom,Castleman-Tumor
Magen => Kardianeoplasie,Kardiatumor,Magengeschwulst,Magenneoplasie,Magentumor
Dünndarm => Duodenaltumor,Dünndarmneoplasie,Dünndarmtumor,Ileumtumor
Kolon => Colon-descendens-Tumor,Colon-sigmoideum-Tumor,Colon-transversum-Tumor,Dickdarmneoplasie,Dickdarmtumor,Ileozäkaltumor,Kolonneoplasie,Kolontumor,Sigmaneoplasie,Sigmatumor,Zäkumneoplasie,Zäkumtumor
Rektum => Rektumgeschwulst,Rektumneoplasie,Rektumtumor
Pankreas => Bauchspeicheldrüsentumor,G-Zell-Tumor,Inselzelltumor,Pankreasgeschwulst,Pankreaskopftumor,Pankreasneoplasie,Pankreastumor,Pankreatoduodenaltumor
Larynx => Larynxgeschwulst,Larynxneoplasie,Larynxtumor
Mediastinum => Mediastinaltumor
Uterus => Stromaendometriose,Uterusgeschwulst,Uterusneoplasie,Uterustumor,Zervixneoplasie
Ovar => Follikulom,Ovarialtumor,Theka-Granulosazell-Tumor
Plazenta => Chorioadenoma,Chorionadenom,Chorionadenoma,Chorionepitheliose,Plazentatumor,Trophoblasttumor
Prostata => Prostatageschwulst,Prostataknoten,Prostatamittellappentumor,Prostataneoplasie,Prostataneoplasma-Rezidiv,Prostataseitenlappentumor,Prostatatumor
Hoden => Hodengeschwulst,Hodenknoten,Hodenmischtumor,Hodentumor,Testistumor
Niere => Nierenneoplasie,Nierenparenchymtumor,Nierenpoltumor,Nierentumor,Reninom
Nierenbecken => Nierenbeckenpapillom,Nierenbeckentumor
Ureter => Harnleitertumor,Ureterpapillom,Uretertumor
Urethra => Harnröhrentumor,Urethratumor
Harnblase => Blasenhalspolyp,Blasenhalstumor,Blasenpapillom,Blasenpapillomatose,Blasenpolyp,Blasenschleimhautpolyp,Blasensphinkterpolyp,Blasentumor,Blasenwandtumor,Harnblasenausgangspolyp,Harnblasenhalspolyp,Harnblasenpapillom,Harnblasenpapillomatose,Harnblasenpolyp,Harnblasenschleimhautpolyp,Harnblasenseitenwandtumor,Harnblasentumor,Harnblasenwandtumor,Urachustumor
Schilddrüse => Schilddrüsenneoplasie,Schilddrüsenneoplasma,Schilddrüsenteratom,Schilddrüsentumor,Thyreoideatumor
Nebenniere => Nebennierenraumforderung,Nebennierentumor,Parenchymtumor
Hypophyse => Hypophysengeschwulst,Hypophysenneoplasie,Hypophysenteratom,Hypophysentumor
Osteomyelofibrose => Knochenmarkfibrose,Knochenmarkhyperplasie,Markfibrose,Myelofibrose,Myelofibrosesyndrom,Myeloretikulose,Myelosklerose,Osteomyelofibrose,Osteomyelofibrosesyndrom,Osteomyeloretikulose,Osteomyeloretikulosesyndrom,Osteomyelosklerose,Osteomyelosklerosesyndrom
Peritoneum => Douglastumor,Peritonealteratom,Peritonealtumor
Haut => Analrandtumor,Augenlidgeschwulst,Augenlidneoplasie,Augenlidtumor,Badehosen-Nävus,Bathing-trunk-Naevus,Gehörgangshautneubildung,Hautneubildung,Hauttumor,Lidgeschwulst,Oberlidneoplasie,Oberlidtumor,Schweißdrüsentumor,Schwimmhosen-Nävus,Unterlidneoplasie,Unterlidtumor
Eiweißmangelanämie => Aminosäuremangelanämie,Eiweißmangelanämie,Proteinmangelanämie
Skorbutanämie => Skorbutanämie
Alpha-Thalassämie => Alpha-Thalassämie
Beta-Thalassämie => Beta-Thalassämie,Cooley-Anämie,Cooley-Krankheit,Cooley-Syndrom
Delta-Beta-Thalassämie => Delta-Beta-Thalassämie
Thalassämie-Erbanlage => Thalassämie-Erbanlage
Sichelzellen-Erbanlage => Hb-AS-Erbanlage,Hb-S-Erbanlage,Sichelzellenerbanlage,Sichelzellenheterozygotie
Willebrand-Jürgens-Syndrom => Angiohämophilie,Angiohämophilie-Syndrom,Bernuth-Pseudohämophilie,Pseudohämophilie,Von-Bernuth-Syndrom,Von-Willebrand-Jürgens-Syndrom,Willebrand-Jürgens-Thrombopathie
Eosinophilie => Eosinophilie,Hypereosinophilie
Hyposplenismus => Hypospleniesyndrom,Hyposplenismus,Milzatrophie,Milzdegeneration,Milzkapselhyalinose
Hypersplenismus => Gamna-Krankheit,Gandy-Nanta-Krankheit,Hypersplenie,Hyperspleniesyndrom,Hypersplenismus,Milzmetaplasie
Nezelof-Syndrom => Nezelof-Syndrom
Wiskott-Aldrich-Syndrom => Wiskott-Aldrich-Syndrom
Di-George-Syndrom => Di-George-Syndrom,Thymusalymphoplasie,Thymusaplasie,Thymusdysplasie
Kryoglobulinämie => Kryoglobulinämie
Immunrekonstitutionssyndrom => Immunrekonstitutionssyndrom
Myxödemkoma => Myxödemkoma
Autoimmunthyreoiditis => Autoimmunthyreoiditis,Autoimmunthyreopathie,Hashimoto-Krankheit,Hashimoto-Struma,Hashimoto-Syndrom,Hashimoto-Thyreoiditis,Hashitoxikose,Immunthyreoiditis
Pseudohypoparathyreoidismus => Pseudohypoparathyreoidismus
Hyperprolaktinämie => Forbes-Albright-Syndrom,Galaktorrhoe-Amenorrhoe-Syndrom,Hyperprolaktinämie
Hypopituitarismus => Apituitarismus,De-Morsier-Syndrom,Hypophysenhinterlappenunterfunktion,Hypophyseninsuffizienz,Hypophysennekrose,Hypophysenunterfunktion,Hypophysenvorderlappenunterfunktion,Hypopituitarismus,Hypopituitarismus-Syndrom,Kallmann-Syndrom,Levi-Minderwuchs,Lorain-Kleinwuchs,Lorain-Levi-Minderwuchs,Lorain-Syndrom,Lorain-Zwergwuchs,Panhypopituitarismus,Pasqualini-Syndrom,Reye-Sheehan-Syndrom,Sheehan-Krankheit,Sheehan-Syndrom,Simmonds-Kachexie,Simmonds-Krankheit,Simmonds-Sheehan-Syndrom,Wachstumshormonmangel
Nelson-Tumor => Nelson-Syndrom,Nelson-Tumor
Addison-Krise => Addison-Krise,Nebennierenkrise,Nebennierenrindenkrise
Nebennierenmarküberfunktion => Hyperadrenalismus,Hyperadrenie
Östrogenüberschuss => Hyperöstrogenismus,Östrogenüberschuss
Androgenüberschuss => Androgenisierung,Androgenüberschuss
Karzinoid-Syndrom => Cassidy-Scholte-Syndrom,Flushsyndrom,Hedinger-Syndrom,Karzinoidose,Karzinoidsyndrom,Steiner-Voerner-Syndrom
Kwashiorkor => Kwashiorkor,Kwashiorkor-Syndrom,Mehrmangel-Syndrom,Polykarenzsyndrom
Kwashiorkor-Marasmus => Kwashiorkor-Marasmus
Beriberi => Beriberi,Kakké,Reisesser-Krankheit,Beriberi-Herzkrankheit,Beriberi-Kardiomyopathie
Wernicke-Enzephalopathie => Wernicke-Enzephalopathie,Wernicke-Krankheit,Wernicke-Polioenzephalitis,Wernicke-Syndrom
Riboflavinmangel => Alactoflavinose [Vitamin-B2-Mangel-Syndrom],Ariboflavinose,Ariboflavinose-Syndrom,Avitaminose B2,Riboflavinmangel,Riboflavinmangel-Syndrom
Pyridoxinmangel => Pyridoxalmangel,Pyridoxaminmangel,Pyridoxinmangel
Askorbinsäuremangel => Askorbinsäuremangel,Cheadle-Krankheit,Möller-Barlow-Krankheit,Skorbut,Vitamin-C-Mangel
Vitamin-E-Mangel => Tokopherolmangel,Vitamin-E-Mangel
Vitamin-K-Mangel => Vitamin-K-Mangel
Kupfermangel => Kupfermangel
Eisenmangel => Eisenmangel,Sideropenie
Magnesiummangel => Magnesiummangel
Manganmangel => Manganmangel
Chrommangel => Chrommangel
Molybdänmangel => Molybdänmangel
Vanadiummangel => Vanadiummangel
Hyperkarotinämie => Hyperkarotinämie,Karotinämie
Albinismus => Achromasie,Achromie,Albinismus,Albinismussyndrom,Albino,Chediak-Steinbrinck-Higashi-Anomalie,Chediak-Steinbrinck-Higashi-Krankheit,Chediak-Steinbrinck-Higashi-Syndrom,Cross-McKusick-Breen-Syndrom,Hermansky-Pudlak-Syndrom,Klein-Waardenburg-Syndrom,Waardenburg-Syndrom,Weißsucht
Hyperchylomikronämie => Bürger-Grütz-Krankheit,Bürger-Grütz-Syndrom,Hyperchylomikronämie
Lipoproteinmangel => A-Beta-Lipoproteinämie,Akanthozytose,Alphahypolipoproteinämie,Analphalipoproteinämie,Bassen-Kornzweig-Krankheit,Bassen-Kornzweig-Syndrom,Betahypolipoproteinämie,High-density-Lipoprotein-Mangel,Hypoalphalipoproteinämie,Hypobetalipoproteinämie,Hypolipoproteinämie,Lecithin-Cholesterin-Acyltransferase-Mangel,Lipoproteinmangel,Tangier-Krankheit,Tangier-Syndrom
Lesch-Nyhan-Syndrom => Lesch-Nyhan-Syndrom
Gilbert-Meulengracht-Syndrom => Gilbert-Cholämie,Gilbert-Krankheit,Gilbert-Meulengracht-Syndrom,Meulengracht-Syndrom
Crigler-Najjar-Syndrom => Crigler-Najjar-Krankheit,Crigler-Najjar-Syndrom,Glucuronyltransferasemangel
Kalziphylaxie => Kalziphylaxie
Volumenmangel => Anhydratation,Anhydration,Anhydrämie,Austrocknung,Blutvolumenverringerung,Dehydratation,Dehydration,Exsikkose,Flüssigkeitsverlust,Hypohydratation,Hypovolämie,Plasmavolumenverringerung,Volumenmangel,Wasserverlust
Azidose => Azidose,Azidämie,Ketoazidose a.n.k.,Kussmaul-Atmung,Laktatazidose
Alkalose => Alkaliämie,Alkalose
Hyperkaliämie => Hyperkaliämie,Hyperkaliämie-Syndrom,Hyperpotassämie,Kaliumintoxikationssyndrom,Kaliumvergiftungssyndrom,Kaliumvermehrung,Kaliumüberschuss
Hypokaliämie => Hypokaliämie,Hypokaliämie-Syndrom,Kalium-Verlustsyndrom,Kaliummangel,Kaliumverarmung
Flüssigkeitsüberschuss => Flüssigkeitsüberlastung,Flüssigkeitsüberschuss,Hyperhydratation,Hypervolämie,Verdünnungshyponatriämie,Wasserintoxikation,Wasservergiftung
Tumorlyse-Syndrom => Tumorlyse-Syndrom
Multiinfarkt-Demenz => Multiinfarktdemenz
Hypomanie => Hypomanie
Zyklothymia => Zyklothymia,Zyklothymie
Dysthymia => Dysthymia,Dysthymie
Anpassungsstörungen => Adaptationsstörung,Adaptationssyndrom,Anpassungsstörung,Anpassungssyndrom,Heimweh,Kulturschock,Nostalgie,Stresssyndrom,Trauerreaktion,Trennungsangst
Somatisierungsstörung => Briquet-Störung,Briquet-Syndrom,Somatisierungsstörung
Atmungssystem => Atemneurose,Hyperventilationssyndrom,Larynxneurose,Pharynxneurose
Urogenitalsystem => Blasenneurose,Genitalneurose,Harnblasenneurose
Neurasthenie => Beard-Krankheit,Beard-Syndrom,Ermüdungsneurose,Ermüdungssyndrom,Erschöpfungsneurose,Erschöpfungssyndrom,Müdigkeitssyndrom,Nervenschwäche,Neurasthenie,Neurastheniesyndrom,Pseudoneurasthenie,Überforderungssyndrom,Überlastung,Überlastungssyndrom
Orgasmusstörung => Anorgasmie,Dysorgasmie,Orgasmusschwierigkeiten,Orgasmusstörung
Antidepressiva => Antidepressivaabusus,Antidepressivamissbrauch
Laxanzien => Laxanzienabusus,Laxanziengewöhnung,Laxanzienmissbrauch
Analgetika => Analgetikaabusus,Analgetikamissbrauch,Schmerzmittelabusus
Antazida => Antazidaabusus,Antazidamissbrauch
Vitamine => Vitaminabusus,Vitaminmissbrauch
Borderline-Typ => Borderline-Persönlichkeitsstörung
Trichotillomanie => Trichotillomanie
Transsexualismus => Transsexualismus
Fetischismus => Fetischismus
Exhibitionismus => Exhibitionismus
Voyeurismus => Voyeurismus
Pädophilie => Päderastie,Pädophilie
Sadomasochismus => Algolagnie,Masochismus,Sadismus,Sadomasochismus
Artikulationsstörung => Artikulationsauffälligkeit,Artikulationsstörung,Dyslalie,Idioglossie,Lallen,Schetismus
Rechenstörung => Entwicklungs-Akalkulie,Rechenschwäche,Rechenstörung
Rett-Syndrom => Rett-Syndrom
Asperger-Syndrom => Asperger-Krankheit,Asperger-Syndrom
Poltern => Poltern
Motoneuron-Krankheit => Bulbärparalyse,Bulbärsyndrom,Charcot-II-Syndrom,Duchenne-Aran-Krankheit,Duchenne-Aran-Muskelatrophie,Duchenne-Aran-Syndrom,Duchenne-II-Syndrom,Lateralparalyse,Lateralsklerose,Motoneuronkrankheit,Pseudobulbärparalyse,Seitenstrangsklerose,Vorderhornganglienzellkrankheit
Postpolio-Syndrom => Postpolio-Syndrom,Postpoliomyelitis-Syndrom
Hallervorden-Spatz-Syndrom => Hallervorden-Spatz-Krankheit,Hallervorden-Spatz-Syndrom
Blepharospasmus => Augenlidspasmus,Blepharoklonus,Blepharospasmus,Lidkrampf,Orbikularis-Spasmus
Myoklonus => Einschlafzuckungen,Myoklonie,Myoklonus
Lewy-Körper-Demenz => Lewy-Körper-Demenz,Lewy-Körper-Krankheit
Pseudo-Lennox-Syndrom => Pseudo-Lennox-Syndrom
Grand-mal-Status => Grand-Mal-Status
Petit-mal-Status => Petit-Mal-Status
Cluster-Kopfschmerz => Bing-Horton-Syndrom,Cluster-Kopfschmerz-Syndrom,Cluster-Kopfschmerzen,Histamin-Kopfschmerzen,Horton-Kopfschmerzen,Horton-Neuralgie,Horton-Syndrom,Nasoziliarneuralgie,Ziliarisneuralgie
Spannungskopfschmerz => Spannungskopfschmerzen
Trigeminusneuralgie => Fothergill-Neuralgie,Infraorbitalneuralgie,Ophthalmikusneuralgie,Quintus-Neuralgie,Supraorbitalneuralgie,Trigeminusneuralgie
Fazialisparese => Bell-Fazialisparese,Bell-Lähmung,Bell-Paralyse,Bell-Syndrom,Fazialislähmung,Fazialisparese,Fazioplegie,Gesichtslähmung,Gesichtsnervenparalyse,Gesichtsparese,Prosopodiplegie,Prosopoplegie
Melkersson-Rosenthal-Syndrom => Melkersson-Rosenthal-Syndrom
Phantomschmerz => Phantomschmerzen
Karpaltunnel-Syndrom => Karpaltunnelsyndrom
Kausalgie => Kausalgie,Kausalgie-Syndrom
Tarsaltunnel-Syndrom => Tarsaltunnelsyndrom
Interkostalneuropathie => Interkostalneuralgie,Interkostalneuropathie
Refsum-Krankheit => Refsum-Krankheit,Refsum-Syndrom
Guillain-Barré-Syndrom => Barré-Guillain-Krankheit,Enzephalomyeloradikulitis,Guillain-Barré-Polyradikulitis,Guillain-Barré-Syndrom,Kussmaul-Landry-Lähmung,Landry-Guillain-Barré-Paralyse,Landry-Guillain-Barré-Syndrom,Landry-Paralyse,Miller-Fisher-Syndrom,Polyradikuloneuritis,Radikuloneuritis
Serumpolyneuropathie => Serumneuritis,Serumneuropathie,Serumpolyneuropathie
Alkohol-Polyneuropathie => Alkoholpolyneuropathie
Critical-illness-Polyneuropathie => Critical-illness-Polyneuropathie
Muskeldystrophie => Beckengürtelmyopathie,Becker-Dystrophie,Becker-Krankheit,Duchenne-Griesinger-Krankheit,Duchenne-Muskeldystrophie,Duchenne-von-Leyden-Syndrom,Erb-Dystrophie,Erb-Krankheit,Erb-Muskeldystrophie,Erb-Syndrom,Gnomenwaden,Landouzy-Déjerine-Atrophie,Landouzy-Déjerine-Dystrophie,Landouzy-Muskeldystrophie,Leyden-Moebius-Dystrophie,Muskeldystrophie,Rumpfgürtel-Muskeldystrophie,Schultergürtelmyopathie,Skapuloperonäalsyndrom
Alkoholmyopathie => Alkoholmyopathie
Critical-illness-Myopathie => Critical-illness-Myopathie
Locked-in-Syndrom => Locked-in-Syndrom
Horner-Syndrom => Claude-Bernard-Horner-Syndrom,Horner-Bernard-Syndrom,Horner-Symptomenkomplex,Horner-Syndrom,Horner-Trias
Multisystem-Atrophie => Multisystematrophie,Multisystemdegeneration,Shy-Drager-Syndrom
Hirnzysten => Arachnoidalzyste,Gehirnzyste,Hirnerweichungszyste,Hirnhautzyste,Hirnzyste,Kleinhirnzyste,Meningenzyste
Hirnödem => Gehirnschwellung,Gehirnödem,Hirnschwellung,Hirnödem
Reye-Syndrom => Reye-Syndrom
Chalazion => Chalazion,Hagelkorn,Unterlidchalazion
Blepharitis => Blepharadenitis,Blepharitis,Lidhautentzündung,Lidrandentzündung,Lidrandfollikulitis
Lagophthalmus => Hasenauge,Lagophthalmus,Lidschließdefekt,Lidspaltendilatation,Lidspaltenerweiterung
Blepharochalasis => Augenlidchalodermie,Augenliddermatolyse,Blepharochalasis,Blepharodermatochalasis
Dakryoadenitis => Dakryoadenitis,Tränendrüsenabszess,Tränendrüsenentzündung,Tränendrüsenfurunkel,Tränendrüseninfektion,Tränendrüsenkarbunkel
Epiphora => Epiphora,Tränenträufeln
Exophthalmus => Augapfelverlagerung,Augenhöhlenödem,Exophthalmus,Orbitablutung,Orbitahämatom,Orbitahämorrhagie,Orbitaödem,Proptosis,Pseudoexophthalmus
Enophthalmus => Enophthalmus,Pseudoenophthalmus
Blepharokonjunktivitis => Blepharokonjunktivitis,Kanthusabszess
Pterygium => Pterygium
Skleritis => Lederhautabszess,Lederhautentzündung,Skleraabszess,Skleraentzündung,Skleraulkus,Skleritis,Sklerokonjunktivitis,Sklerotenonitis
Episkleritis => Episkleraentzündung,Episkleritis
Keratokonjunktivitis => Expositionskeratokonjunktivitis,Keratokonjunktivitis,Phlyktäne,Phlyktänenbildung
Hornhautdegeneration => Gerontoxon,Hassal-Henle-Warze,Hornhautabscherung,Keratomalazie,Korneadegeneration,Korneanekrose,Krokodil-Chagrin-Hornhautdegeneration,Salzmann-Dystrophie,Salzmann-Hornhautdegeneration,Vogt-Limbusgürtel
Keratokonus => Keratokonus
Hyphäma => Hyphäma,Irisblutung,Irishämorrhagie,Ziliarkörperblutung,Ziliarkörperhämorrhagie
Pupillarmembranen => Pupillarmembran,Pupillenokklusion,Pupillenverschluss
Aphakie => Aphakie
Netzhautblutung => Makulablutung,Netzhautblutung,Netzhautstreifenblutung,Retinablutung,Retinastreifenblutung,Terson-Syndrom
Glaukomverdacht => Augapfelhypertonie,Augendruckerhöhung,Augenhypertension,Augeninnendruckerhöhung,Augenüberdruck,Glaukomgrenzfall,Glaukomverdacht
Glaskörperprolaps => Glaskörperprolaps
Glaskörperblutung => Glaskörperblutung,Glaskörperhämatom,Glaskörperhämorrhagie
Optikusatrophie => Leber-Optikusatrophie,Leber-Syndrom,Optikusatrophie,Papillenabblassung,Papillenatrophie,Papillenblässe,Papillenexkavation,Sehnervatrophie
Heterophorie => Esophorie,Exophorie,Heterophorie,Hyperphorie,Hypophorie,Nahexophorie,Zyklophorie
Hypermetropie => Achsenhypermetropie,Achsenhyperopie,Brechungshypermetropie,Brechungshyperopie,Hypermetropie,Hyperopie,Weitsichtigkeit,Übersichtigkeit
Myopie => Achsenmyopie,Brechungsmyopie,Kurzsichtigkeit,Myopie
Astigmatismus => Astigmatismus,Stabsichtigkeit
Presbyopie => Altersauge,Alterssichtigkeit,Presbyopie
Akkommodationsstörungen => Akkommodationsbeschwerden,Akkommodationsdefizit,Akkommodationsinsuffizienz,Akkommodationskrampf,Akkommodationslähmung,Akkommodationsparalyse,Akkommodationsparese,Akkommodationsschwäche,Akkommodationsspasmus,Akkommodationsstörung,Zykloplegie,Zyklospasmus
Diplopie => Diplopie,Doppelbilder,Doppelsichtigkeit,Doppeltsehen
Gesichtsfelddefekte => Anopsie,Bjerrumskotom,Bogenskotom,Gesichtsfeldausfall,Gesichtsfeldbegrenzung,Gesichtsfelddefekt,Gesichtsfelddeformität,Gesichtsfeldeinengung,Gesichtsfeldeinschränkung,Gesichtsfeldkontraktion,Halbseitenblindheit,Halbsichtigkeit,Hemianopsie,Quadrantenanopsie,Quadrantenhemianopsie,Ringskotom,Skotom
Farbsinnstörungen => Achloropsie,Achromatopsie,Anerythropsie,Azyanopsie,Blau-Gelb-Schwäche,Daltonismus,Deuteranomalie,Deuteranopie,Dichromasie,Dichromatopsie,Dyschromatopsie,Einfarbensehen,Farbenblindheit,Farbenfehlsichtigkeit,Farbsinnstörung,Gelb-Blau-Schwäche,Grün-Rot-Schwäche,Grünblindheit,Monochromasie,Protanomalie,Protanopie,Rot-Grün-Blindheit,Rot-Grün-Schwäche,Rotblindheit,Rotschwäche,Tritanomalie,Tritanopie,Xanthopsie
Nachtblindheit => Dämmerungsamblyopie,Dämmerungsblindheit,Dämmerungssehstörung,Nachtblindheit,Oguchi-Krankheit,Oguchi-Syndrom
Pupillenfunktionsstörungen => Adie-Syndrom,Anisokorie,Iridoparalysis,Iridoplegie,Irisparalyse,Miosis,Mydriasis,Pupillendifferenz,Pupillendilatation,Pupillenentrundung,Pupillenerweiterung,Pupillenmyotonie,Pupillenstörung,Pupillotonie
Augenschmerzen => Augenbewegungsschmerzen,Augenbrennen,Augendrücken,Augenneuralgie,Augenschmerzen,Augenstechen,Orbitaschmerzen,Reizauge
Zeruminalpfropf => Ohrpfropf,Ohrschmalzpfropf,Zerumen,Zerumenpfropf,Zeruminalpfropf
Petrositis => Felsenbeinabszess,Felsenbeineiterung,Felsenbeinentzündung,Felsenbeinosteomyelitis,Petrositis,Pyramideneiterung
Tympanosklerose => Trommelfellverhärtung,Tympanosklerose
Ménière-Krankheit => Labyrinth-Vertigo,Labyrinthhydrops,Ménière-Krankheit,Ménière-Schwindel,Ménière-Symptomenkomplex,Ménière-Syndrom,Ménière-Vertigo,Vestibularis-Syndrom
Labyrinthitis => Fensterlabyrinthitis,Innenohrentzündung,Innenohrhyperämie,Labyrintheiterung,Labyrinthentzündung,Labyrinthhyperämie,Labyrinthitis,Perilabyrinthitis,Vestibulitis
Labyrinthfistel => Bogengangfistel,Innenohrfistel,Labyrinthfistel
Presbyakusis => Altersschwerhörigkeit,Presbyakusis
Otalgie => Mastoidalgie,Ohrbeschwerden,Ohrenschmerzen,Ohrneuralgie,Otagra,Otalgia,Otalgie,Otodynie,Otoneuralgie,Retroaurikularneuralgie,Warzenfortsatzschmerzen
Otorrhoe => Ohrenfluss,Ohrlaufen,Otorrhoe
Mitralklappenstenose => Mitralklappenobstruktion,Mitralklappenstenose,Mitralklappenstriktur,Mitralstenose
Trikuspidalklappenstenose => Trikuspidalklappenstenose,Trikuspidalklappenstriktur
Trikuspidalklappeninsuffizienz => Trikuspidalinsuffizienz,Trikuspidalklappeninsuffizienz,Trikuspidalklappenregurgitation
Postmyokardinfarkt-Syndrom => Dressler-II-Syndrom,Postmyokardinfarktsyndrom
Koronararterienaneurysma => Koronararterienaneurysma,Koronararteriendissektion
Mitralklappeninsuffizienz => Mitralinsuffizienz,Mitralklappeninsuffizienz,Mitralklappenregurgitation
Mitralklappenprolaps => Barlow-Syndrom,Floppy-valve-Syndrom,Mitralklappenprolaps
Aortenklappenstenose => Aortenklappenobstruktion,Aortenklappenstenose,Aortenklappenstriktur
Aortenklappeninsuffizienz => Aortenklappeninsuffizienz,Aortenklappenregurgitation,Austin-Flint-Geräusch,Flint-Geräusch
Pulmonalklappenstenose => Pulmonalklappenobstruktion,Pulmonalklappenstenose,Pulmonalklappenstriktur
Pulmonalklappeninsuffizienz => Graham-Steell-Geräusch,Pulmonalklappeninsuffizienz,Pulmonalklappenregurgitation,Steell-Geräusch
Endokardfibroelastose => Elastomyofibrose,Endokard-Fibroelastose-Syndrom,Endokardfibroelastose,Fibroelastosis
Präexzitations-Syndrom => Antesystolie,Lown-Ganong-Levine-Syndrom,Präexzitationssyndrom,Wolff-Parkinson-White-Syndrom
Vorhofextrasystolie => Vorhofextrasystolen,Vorhofextrasystolie
Sick-Sinus-Syndrom => Sick-Sinus-Syndrom,Sick-Sinus-Tachykardie,Sinusknotensyndrom,Tachykardie-Bradykardie-Syndrom
Myokarddegeneration => Endokardverfettung,Fettherz,Herzdegeneration,Herzerweichung,Herzkalzifikation,Herzmuskelatrophie,Herzmuskeldegeneration,Herzmuskelerkrankung,Herzmuskelkrankheit,Herzmuskelschaden,Herzmuskelverkalkung,Herzossifikation,Herzsteatose,Herzverfettung,Kardiomalazie,Myokardatrophie,Myokarddegeneration,Myokarddystrophie,Myokardkalzifikation,Myokardkrankheit,Myokardossifikation,Myokardschaden,Myokardstenose,Myokardverfettung,Myokardverkalkung
Kardiomegalie => Atriomegalie,Herzhypertrophie,Herzmuskelhypertrophie,Herzventrikelhypertrophie,Herzvergrößerung,Herzvorhofdilatation,Kardiomegalie,Linksherzhypertrophie,Linksherzvergrößerung,Myokardhypertrophie,Rechtsherzdilatation,Rechtsherzhypertrophie,Sportlerherz,Ventrikeldilatation,Ventrikelerweiterung
Moyamoya-Syndrom => Moyamoya-Krankheit,Moyamoya-Syndrom
Raynaud-Syndrom => Raynaud-Gangrän,Raynaud-Krankheit,Raynaud-Phänomen,Raynaud-Syndrom
Arterienstriktur => Arterieneinengung,Arterienknick,Arterienkompression,Arterienstenose a.n.k.,Arterienstriktur,Arterienverengung a.n.k.,Beckenarterienstenose,Kinking-Arterie,Subklaviastenose
Arterienruptur => Arterienfistel,Arterienriss,Arterienruptur,Arterienwandruptur
Arteria-coeliaca-Kompressions-Syndrom => Arteria-coeliaca-Syndrom,Truncus-coeliacus-Kompressionssyndrom
Arteriennekrose => Arteriennekrose,Arteriolonekrose
Pfortaderthrombose => Pfortaderblockade,Pfortaderembolie,Pfortaderobstruktion,Pfortaderstenose,Pfortaderthrombose,Pfortaderverschluss
Budd-Chiari-Syndrom => Chiari-Krankheit,Leberthrombose,Lebervenenblockade,Lebervenenembolie,Lebervenenstenose,Lebervenenthrombose,Lebervenenverschluss,Lebervenenverschlusssyndrom
Skrotumvarizen => Bruchvarizen,Hodenvarikozele,Hodenvenenkonvolut,Skrotumphlebektasie,Skrotumvarizen,Varikozele
Beckenvarizen => Beckenvarikose,Beckenvarizen,Harnblasenphlebektasie,Harnblasenvarizen,Mutterbandvarizen,Ovarialvarikozele,Ovarialvarizen,Pelvivarikose
Vulvavarizen => Labienvarizen,Vulvavarizen
Magenvarizen => Fundusvarizen,Fundusvarizenblutung,Kardiavarizen,Kardiavarizenblutung,Magenvarizen
Venenkompression => Vena-cava-inferior-Kompressionssyndrom,Vena-cava-inferior-Okklusionssyndrom,Vena-cava-inferior-Syndrom,Vena-cava-superior-Kompressionssyndrom,Vena-cava-superior-Okklusionssyndrom,Vena-cava-superior-Syndrom,Vena-cava-Syndrom,Venenkompression,Venenstenose,Venenstriktur
Lymphangitis => Lymphangitis,Lymphgefäßentzündung
Postkardiotomie-Syndrom => Postkardiotomiesyndrom,Postkommissurotomiesyndrom,Postvalvulotomiesyndrom
Nasenseptumdeviation => Nasenmuscheldeflexion,Nasenscheidewanddeviation,Nasenscheidewanddislokation,Nasenscheidewandverbiegung,Nasenscheidewandverkrümmung,Nasenseptumdeformität,Nasenseptumdeviation,Nasenseptumdislokation,Nasenseptumverbiegung,Rhinoseptumdeviation,Rhinoseptumverbiegung,Septumdeviation,Septumverbiegung
Peritonsillarabszess => Intratonsillarabszess,Mandelabszess,Paratonsillarabszess,Paratonsillitis,Periamygdalitis,Peritonsillarabszess,Peritonsillitis,Retrotonsillarabszess,Tonsillarabszess,Tonsillopharyngealabszess
Stimmlippenknötchen => Chorditis,Lehrerknötchen,Schreiknötchen,Stimmbandentzündung,Stimmbandknötchen,Sängerknötchen
Larynxödem => Epiglottisödem,Glottisödem,Kehlkopfödem,Larynxödem,Stimmbandödem,Stimmlippenödem
Laryngospasmus => Glottiskrampf,Glottisspasmus,Kehlkopfspasmus,Laryngismus,Laryngospasmus,Larynxspasmus,Pseudocroup,Pseudokrupp,Stimmritzenkrampf
Kehlkopfstenose => Glottisstenose,Glottisstriktur,Kehlkopfstenose,Kehlkopfstriktur,Laryngostenose,Larynxkonstriktion,Larynxobstruktion a.n.k.,Larynxstenose,Larynxstriktur a.n.k.,Larynxverengung,Larynxverschluss a.n.k.,Ringknorpelstenose
McLeod-Syndrom => McLeod-Syndrom
Bronchiektasen => Bronchiektasie,Bronchiolektasen,Bronchiolendilatation,Bronchiolenerweiterung,Bronchusdilatation,Bronchuserweiterung
Kohlenbergarbeiter-Pneumokoniose => Anthrakose,Anthrakosilikose,Bergleute-Asthma,Bergleute-Pneumokoniose,Bergmannslunge,Kohlenbergarbeiter-Pneumokoniose,Kohlenstaublunge,Lungenanthrakose
Berylliose => Berylliose,Berylliumgranulomatose,Berylliumlunge,Berylliumpneumonie,Berylliumstaublunge,Lungenberylliose
Siderose => Eisenablagerung,Eisenlunge,Eisenstaublunge,Lungensiderose,Pneumosiderose,Siderose
Stannose => Stannose,Zinnarbeiterlunge
Byssinose => Baumwollstaublunge,Byssinose,Byssinose-Syndrom
Flachsarbeiter-Krankheit => Flachsarbeiterkrankheit
Cannabiose => Cannabinosis,Cannabiose
Farmerlunge => Drescher-Krankheit,Drescher-Syndrom,Drescherlunge,Erntearbeiterlunge,Farmerlunge,Getreidearbeiterkrankheit,Getreidearbeiterlunge,Mouldy-hay-Krankheit,Mouldy-hay-Pneumokoniose
Bagassose => Bagasse-Krankheit,Bagasse-Pneumokoniose,Bagasse-Pneumonitis,Bagasse-Staublunge,Bagassose,Bagassosis,Zuckerrohr-Pneumokoniose
Vogelzüchterlunge => Taubenzüchterkrankheit,Taubenzüchterlunge,Vogelhalterkrankheit,Vogelzüchterkrankheit,Vogelzüchterlunge,Wellensittichzüchterkrankheit,Wellensittichzüchterlunge
Suberose => Korkarbeiterkrankheit,Korkarbeiterlunge,Korkrindenschälerkrankheit,Korkrindenschälerlunge,Korkstaublunge,Suberose,Suberosis
Malzarbeiter-Lunge => Malzarbeiterlunge
Pilzarbeiter-Lunge => Pilzarbeiterlunge
Ahornrindenschäler-Lunge => Ahornrindenschälerlunge,Ahornrindenstreiferkrankheit,Ahornrindensyndrom,Towey-Krankheit
Lungenödem => Lungenanschoppung,Lungenhypostase,Lungenstauung,Lungenödem,Prälungenödem,Stauungstracheobronchitis,Wasserlunge
Fibrothorax => Fibrothorax,Pleurafibrose,Pleurahyalinose,Pleurakuppelschwiele,Pleuraschwarte,Pleuraschwiele,Pleuravernarbung,Pleuraverschwartung,Rippenwinkelschwarte
Hämatothorax => Hydrohämatopneumothorax,Hydropneumohämothorax,Hämatopneumothorax,Hämatothorax,Hämopneumothorax,Hämothorax,Pneumohämatothorax
Mendelson-Syndrom => Mendelson-Syndrom
Lungenkollaps => Atelektase,Brock-Graham-Syndrom,Brock-Syndrom,Dystelektase,Graham-Burford-Mayer-Syndrom,Kompressionsapneumatose,Kompressionsatelektase,Lungenatelektase,Lungenflügelatelektase,Lungenkollaps,Mittellappenatelektase,Mittellappensyndrom,Plattenatelektase,Resorptionsatelektase,Streifenatelektase,Totalatelektase,Unterlappenatelektase,Verdrängungsatelektase
Mediastinitis => Mediastinitis,Mediastinumentzündung,Mediastinuminfektion,Mittelfellentzündung
Anodontie => Anodontia,Anodontie,Hypodontie,Oligodontie,Zahnlosigkeit
Hyperodontie => Hyperodontie,Mesiodens,Paramolar
Dentitionskrankheit => Dentitionsbeschwerden,Dentitionskrankheit,Dentitionsschmerzen,Dentitionssyndrom,Zahnfieber,Zahnungsbeschwerden
Kariesmarke => Kariesmarke
Odontoklasie => Melanodontie,Melanodontoklasie,Odontoklasie
Hyperzementose => Zementose
Pulpitis => Odontitis,Pulpaabszess,Pulpapolyp,Pulpitis,Zahnmarkentzündung,Zahnwurzelentzündung
Pulpanekrose => Pulpagangrän,Pulpanekrose
Pulpadegeneration => Denticulus,Dentikel,Pulpadegeneration,Pulpahyalinose,Pulpakalzifikation,Pulpastein,Pulpaverkalkung
Parodontose => Paradentose,Parodontose,Zahnfleischschwund
Gingivaretraktion => Gingivaretraktion,Zahnfleischatrophie,Zahnfleischretraktion,Zahnfleischschrumpfung
Gingivahyperplasie => Gingivafibromatose,Gingivahyperplasie,Zahnfleischfibromatose,Zahnfleischhyperplasie,Zahnfleischhypertrophie,Zahnfleischverdickung
Zahnstellungsanomalien => Gebissanomalie,Zahndiastema,Zahnengstand,Zahnfehlstellung,Zahnlageanomalie,Zahnrotation,Zahnstellungsanomalie,Zahntransposition,Zahnverlagerung
Speicheldrüsenatrophie => Parotisatrophie,Speicheldrüsenatrophie,Speicheldrüseninvolution,Speicheldrüsenlipomatose
Speicheldrüsenhypertrophie => Parotishypertrophie,Speicheldrüsenhyperplasie,Speicheldrüsenhypertrophie
Sialadenitis => Ohrspeicheldrüsenentzündung,Parotisentzündung,Parotisinfektion,Parotitis,Sialadenitis,Sialitis,Sialoadenitis,Sialodochitis,Speicheldrüseneiterung,Speicheldrüsenentzündung
Speicheldrüsenabszess => Parotisabszess,Speicheldrüsenabszess
Speicheldrüsenfistel => Parotisfistel,Speicheldrüsenfistel,Speichelgangfistel
Sialolithiasis => Sialodocholithiasis,Sialolith,Sialolithiasis,Speicheldrüsengangstein,Speicheldrüsenstein,Speichelstein,Speichelsteinleiden,Submandibulärstein
Wangenabszess => Wangenabszess,Wangenschleimhautabszess
Haarleukoplakie => Haarleukoplakie
Glossitis => Fede-Riga-Krankheit,Gingivoglossitis,Glossitis,Hunter-Glossitis,Möller-Glossitis,Möller-Hunter-Glossitis,Subglossitis,Zungenabszess,Zungenentzündung,Zungengeschwür,Zungeninfektion a.n.k.,Zungenpapillitis,Zungenulzeration
Glossodynie => Glossalgie,Glossodynie,Glossopyrosis,Zungenbrennen,Zungenschmerzen
Ösophagitis => Speiseröhrenabszess,Speiseröhrenentzündung,Virusösophagitis,Ösophagitis,Ösophagusabszess,Ösophagusentzündung,Ösophaguserosion,Ösophagusschleimhauterosion
Ösophagusulkus => Kardiaulkus,Ösophagusgeschwür,Ösophagusulkus
Ösophagusverschluss => Kardiaobstruktion a.n.k.,Kardiastenose,Kardiastriktur,Kardiaverschluss,Speiseröhreneinengung,Speiseröhrenstenose,Speiseröhrenstriktur,Ösophaguseinengung,Ösophaguskompression,Ösophaguskonstriktion,Ösophagusobstruktion,Ösophagusstenose,Ösophagusstriktur,Ösophagusverschluss
Mallory-Weiss-Syndrom => Boerhaave-Syndrom,Magenschleimhautriss,Mallory-Weiss-Läsion,Mallory-Weiss-Syndrom
Barrett-Ösophagus => Barrett-Syndrom,Barrett-Ösophagitis,Barrett-Ösophagus
Alkoholgastritis => Alkoholgastritis
Duodenitis => Duodenalbulbitis,Duodenalentzündung,Duodenalkatarrh,Duodenitis,Oberflächenduodenitis,Periduodenitis,Zwölffingerdarmentzündung
Dyspepsie => Dyspepsie,Dyspepsiedarm,Fäulungsdyspepsie,Gärungsdyspepsie,Indigestion,Maldigestion,Reflexdyspepsie,Reizmagen,Säureindigestion,Verdauungsinsuffizienz,Verdauungsschwäche,Verdauungsstörung
Magendivertikel => Magendivertikel
Duodenalverschluss => Duodenalkonstriktion,Duodenalobstruktion,Duodenalstenose,Duodenalstriktur,Duodenalverschluss
Appendixkonkremente => Appendixkonkrement,Appendixstein
Appendixdivertikel => Appendixdivertikel
Appendixfistel => Appendixfistel
Invagination => Darmeinscheidung,Darmeinstülpung,Darminvagination,Dünndarminvagination,Intussuszeption,Invagination,Invaginationsileus,Koloneinscheidung,Koloninvagination
Volvulus => Darmachsendrehung,Darmstrangulation,Darmtorsion,Darmverknotung,Darmverschlingung,Darmvolvulus,Duodenaltorsion,Dünndarmvolvulus,Ileumvolvulus,Intestinalstrangulation,Intestinaltorsion,Kolonstrangulation,Kolontorsion,Sigmavolvulus,Torsionsileus,Volvulus
Gallensteinileus => Gallensteinileus
Obstipation => Darmträgheit,Dyschezie,Hartleibigkeit,Obstipation,Stuhlträgheit,Stuhlverhalten,Stuhlverhaltung,Stuhlverstopfung,Verstopfung
Analspasmus => Analspasmus,Proktospasmus
Analfistel => Analfistel
Rektalfistel => Mastdarmfistel,Rektum-Haut-Fistel,Rektumfistel
Analabszess => Analabszess,Analphlegmone,Anusabszess,Perianalabszess
Rektalabszess => Pararektalabszess,Perirektalabszess,Rektalabszess,Rektalphlegmone,Rektumfurunkel,Rektumkarbunkel
Analpolyp => Analkanalpolyp,Analpolyp
Rektumpolyp => Rektumpolyp
Analprolaps => Aftervorfall,Analektropium,Analkanalprolaps,Analprolaps,Analschleimhautprolaps
Rektumprolaps => Mastdarmvorfall,Proktoptose,Rektumprolaps,Rektumvorfall
Strahlenproktitis => Strahlenproktitis
Darmabszess => Darmabszess,Darmeiterung,Darmphlegmone,Darmwandabszess,Dünndarmphlegmone,Intestinalabszess a.n.k.,Sigmaabszess
Darmfistel => Abdomenfistel,Bauchdeckenfistel,Bauchwandfistel,Darmfistel a.n.k.,Dünndarmfistel,Ileumfistel,Intestinalfistel,Intestinumfistel a.n.k.,Jejunumfistel,Kolonfistel,Kotfistel,Sigmafistel,Zäkalfistel,Zäkumfistel
Darmulkus => Darmerosion,Darmgeschwür,Darmulkus,Dünndarmgeschwür,Ileumulkus,Kolonulkus,Sigmoidulkus,Zäkumulkus
Enteroptose => Darmprolaps,Darmptose,Darmsenkung,Darmvorfall,Dünndarmprolaps,Eingeweideptose,Eingeweidesenkung,Enteroptose,Gastroenteroptose,Glénard-Krankheit,Intestinalptose,Koloptose,Splanchnoptose,Viszeralptose,Viszeroptose,Zäkumprolaps,Zäkumptose
Hämoperitoneum => Hämoperitoneum,Mesenterialblutung,Peritonealblutung,Retroperitonealhämatom
Leberfibrose => Leberfibrose,Narbenleber
Lebersklerose => Lebersklerose
Leberabszess => Leberabszess
Leberinfarkt => Leberapoplexie,Leberinfarkt
Gallenblasenfistel => Cholezystoduodenalfistel,Gallenblasen-Magen-Fistel,Gallenblasenduodenalfistel,Gallenblasenfistel
Cholangitis => Cholangiolitis,Cholangitis,Choledochitis,Choledochusentzündung,Choledochusinfektion,Duodenocholangitis,Gallengangsentzündung,Gallengangsinfektion,Gallenwegsentzündung,Pericholangiolitis
Pankreaszyste => Pankreasgangzyste,Pankreaszyste
Zöliakie => Czerny-Spätatrophie,Gee-Herter-Thaysen-Krankheit,Gee-Thaysen-Krankheit,Glutenallergie,Glutenenteropathie,Glutenunverträglichkeit,Herter-Gee-Syndrom,Herter-Heubner-Syndrom,Herter-Infantilismus,Heubner-Herter-Krankheit,Sprue-Syndrom,Thaysen-Krankheit,Zöliakie
Postcholezystektomie-Syndrom => Postcholezystektomiebeschwerden,Postcholezystektomiesyndrom
Hämatemesis => Bluterbrechen,Hämatemesis,Hämatinerbrechen
Meläna => Blutstuhl,Hämatochezie,Meläna,Pechstuhl,Schwarzruhr,Teerstuhl
Pyodermie => Ecthyma,Hauteiterung,Pyodermatitis,Pyodermie a.n.k.,Staphylodermie
Erythrasma => Erythrasma
Windeldermatitis => Jacquet-Dermatitis,Windelausschlag,Windeldermatitis,Windeldermatose,Windelerythem
Psoriasis-Arthropathie {M07.0-M07.3}, {M09.0-} => Gelenkpsoriasis,Psoriasis-Arthritis,Psoriasis-Arthropathie
Kontakturtikaria => Kontakturtikaria
Strahlengranulom => Strahlengranulom
Onycholysis => Onycholyse,Onycholysis
Nageldystrophie => Fingernagelbrüchigkeit,Hohlnagel,Koilonychie,Löffelnagel,Nagelatrophie,Nagelbrüchigkeit,Nageldystrophie,Nagelerweichung,Onychodystrophie,Onychomalazie,Onychorrhexis,Onychoschisis,Schizonychia
Beau-Reil-Querfurchen => Beau-Reil-Querfurchen,Nagelquerfurchen
Ophiasis => Ophiasis
Telogeneffluvium => Telogeneffluvium
Anageneffluvium => Anageneffluvium
Hirsutismus => Hirsutismus
Polytrichie => Polytrichie
Rhinophym => Knollennase,Rhinophym
Epidermalzyste => Augenlidmilien,Epidermalzyste,Epidermiszyste,Epidermoidzyste,Epithelzyste,Milien,Schleimhautzyste
Trichilemmalzyste => Atherom,Balggeschwulst,Grützbeutel,Hautatherom,Pilarzyste,Skrotumatherom,Skrotumzyste,Steatom,Talgdrüsentumor,Talgdrüsenzyste,Talgzyste,Trichilemmalzyste,Trichodermalzyste
Anhidrosis => Anhidrose,Anidrose,Hypohidrose,Oligohidrose
Bromhidrosis => Bromhidrose,Bromidrose,Osmidrose
Chromhidrosis => Chromhidrose,Chromidrose
Vitiligo => Vitiligo
Epheliden => Epheliden,Sommersprossen
Café-au-lait-Flecken => Café-au-lait-Flecken
Pigmentpurpura => Majocchi-Krankheit,Majocchi-Purpura,Pigmentpurpura,Schamberg-Dermatitis,Schamberg-Krankheit,Schamberg-Syndrom
Sklerodaktylie => Sklerodaktylie
Gottron-Papeln => Gottron-Papeln
Ainhum => Ainhum-Syndrom,Guduram
Livedo-Vaskulitis => Livedo-Vaskulitis
Hypersensitivitätsangiitis => Goodpasture-Syndrom,Hypersensitivitätsangiitis
Wegener-Granulomatose => Riesenzellengranuloarteriitis,Wegener-Granulomatose,Wegener-Klinger-Churg-Syndrom,Wegener-Krankheit,Wegener-Syndrom,Lungengranulomatose
Polymyositis => Polymyositis
Behçet-Krankheit => Behçet-Aphthen,Behçet-Krankheit,Behçet-Syndrom
Hypermobilitäts-Syndrom => Hypermobilitätssyndrom
Tortikollis => Schiefhals,Tortikollis
Schmorl-Knötchen => Schmorl-Knorpelknötchen,Schmorl-Knötchen
Zervikobrachial-Syndrom => Zervikobrachialgie,Zervikobrachialsyndrom,Zervikozephalobrachialgie
Zervikalneuralgie => Halswirbelsäulensyndrom,HWS-Schmerzen,HWS-Syndrom,Nackenschmerzen a.n.k.,Sensibles C6-C8-Syndrom,Sensibles C6-Syndrom,Zervikago,Zervikalgie,Zervikalneuralgie,Zervikalsyndrom
Ischialgie => Ischialgie,Ischias,Ischiasschmerzen
Lumboischialgie => Lumboischialgie
Kreuzschmerz => Dorsolumbalgie,Hexenschuss,Iliosakralgelenkschmerzen,Kreuzschmerzen,Lendenschmerzen,Lumbago,Lumbalgie,Lumbosakralgie
Kalkaneussporn => Fersensporn,Kalkaneussporn
Metatarsalgie => Metatarsalgie
Pseudokoxalgie => Pseudokoxalgie,Pseudokoxitis
Tietze-Syndrom => Kostochondritis,Kostochondrose,Rippenknorpeldystrophie,Tietze-Krankheit,Tietze-Syndrom
Blumenkohlohr => Blumenkohlohr
Hydroureter => Harnleitererweiterung,Hydropyureter,Hydroureter,Uretererweiterung,Ureterstau
Pyonephrose => Hydropyonephrose,Hydropyoureteronephrose,Pyohydronephrose,Pyonephrose
Analgetika-Nephropathie => Analgetikanephropathie,Analgetikaschrumpfniere,Phenacetin-Nephropathie
Balkan-Nephropathie => Balkannephropathie
Nierenabszess => Nephropyosis,Nierenabszess,Nierenkapselabszess,Nierenkarbunkel,Nierenrindenabszess
Nierenstein => Kalixurolithiasis,Kalziumnephrolithiasis,Kelchstein,Korallenstein,Nephrolithiasis,Nierenausgussstein,Nierenbeckenausgussstein,Nierenbeckenkelchkonkrement,Nierenbeckenkelchstein,Nierenbeckenkonkrement,Nierenbeckensolitärstein,Nierenbeckenstein,Nierengrieß,Nierengrießabgang,Nierenkalziumoxalatstein,Nierenkelchkonkrement,Nierenkelchstein,Nierenkonkrement,Nierenoberkelchkonkrement,Nierenoberkelchstein,Nierenparenchymstein,Nierensand,Nierenstein,Nierensteinabgang,Nierensteingrieß,Nierensteinkolik,Nierenunterkelchkonkrement,Nierenunterkelchstein,Oxalat-Nephrolithiasis
Ureterstein => Harnleitergrieß,Harnleiterkonkrement,Harnleiterstein,Uretergrieß,Ureterkonkrement,Ureterolithiasis,Ureterozelenstein,Ureterstein
Urethrastein => Harnröhrenstein,Urethrakonkrement,Urethralithiasis,Urethrastein
Trigonumzystitis => Trigonitis,Trigonumzystitis,Urethrotrigonitis,Urethrotrigonumzystitis
Strahlenzystitis => Bestrahlungszystitis,Radiozystitis,Radiumblase,Strahlenzystitis
Blasenhalsobstruktion => Blasenauslassobstruktion,Blasenhalsenge,Blasenhalsobstruktion,Blasenhalsstenose,Blasenhalsstriktur,Blasenhalsödem,Harnblasenausgangsstenose,Harnblasenhalsenge,Harnblasenhalsobstruktion,Harnblasenhalsstarre,Harnblasenhalsstenose,Harnblasenhalsstrangulation,Harnblasenhalsstriktur,Harnblasenhalsödem,Marion-Krankheit,Neoblasenhalsstriktur
Vesikointestinalfistel => Blasen-Darm-Fistel,Blasen-Dünndarm-Fistel,Blasen-Sigma-Fistel,Darm-Blasen-Fistel,Harnblasen-Darm-Fistel,Harnblasen-Dünndarm-Fistel,Harnblasen-Ileum-Fistel,Harnblasen-Kolon-Fistel,Harnblasen-Mastdarm-Fistel,Harnblasen-Sigma-Fistel,Pouch-Darm-Fistel
Harnblasendivertikel => Blasendivertikel,Blasenhalsdivertikel,Harnblasendivertikel,Harnblasendivertikulitis,Harnblasenhalsdivertikel
Harnröhrenabszess => Harnröhrenabszess,Harnröhrenphlegmone,Harnröhrenpyozele,Urethraabszess,Urethradrüsenabszess,Urethrakarbunkel,Urethraphlegmone,Urethrapyozele
Harnröhrenfistel => Harnröhren-Damm-Fistel,Harnröhren-Haut-Fistel,Harnröhren-Mastdarm-Fistel,Harnröhrenfistel,Harnwegsfistel,Urethra-Damm-Fistel,Urethra-Haut-Fistel,Urethra-Mastdarm-Fistel,Urethra-Rektum-Fistel,Urethrafistel
Harnröhrendivertikel => Harnröhrendivertikel,Harnröhrendivertikulitis,Harnröhrendivertikulose,Urethradivertikel,Urethradivertikulitis,Urethradivertikulose
Harnröhrenkarunkel => Harnröhrenkarunkel,Urethrakarunkel,Urethralkarunkel
Reflexinkontinenz => Reflexinkontinenz
Überlaufinkontinenz => Überlaufblase
Dranginkontinenz => Urgeblase,Urgeinkontinenz
Flankenschmerz-Hämaturie-Syndrom => Flankenschmerz-Hämaturie-Syndrom
Prostatahyperplasie => Blasen-Prostata-Hyperplasie,Blasenhalskropf,Paraprostatahypertrophie,Prostatahyperplasie,Prostatahypertrophie,Prostataobstruktion,Prostatavergrößerung,Prostatismus,Urethroprostatopathie,Vorsteherdrüsenvergrößerung
Prostataabszess => Prostataabszess
Prostatazystitis => Prostatovesikulitis,Prostatozystitis
Prostatastein => Prostatakonkrement,Prostatalithiasis,Prostatastein
Prostataatrophie => Prostataatrophie
Prostatadysplasie => Prostatadysplasie
Spermatozele => Spermatozele
Hodentorsion => Epididymistorsion,Hodentorsion,Nebenhodentorsion,Samenstrangtorsion,Testistorsion
Hydatidentorsion => Hydatidentorsion
Balanoposthitis => Balanitis,Balanoposthitis,Eichelkatarrh,Posthitis,Vorhautentzündung
Hodenatrophie => Hodenatrophie,Hodenhypotrophie,Testisatrophie
Mastodynie => Brustdrüsenschmerzen,Mammaschmerzen,Mastalgie,Mastodynie
Bartholin-Zyste => Bartholin-Zyste
Bartholin-Abszess => Bartholin-Abszess,Bartholin-Pseudoabszess
Zystozele => Kolpozele,Scheidenprolaps,Scheidensenkung,Scheidenvorfall,Scheidenwandvorfall,Vaginalprolaps,Vaginalsenkung,Vaginaltotalprolaps,Vaginalvorfall,Zystoenterozele,Zystourethrozele,Zystozele
Rektozele => Rektozele
Vesikovaginalfistel => Blasen-Scheiden-Fistel,Harnblasen-Scheiden-Fistel,Harnblasen-Vagina-Fistel,Scheiden-Blasen-Fistel
Hämatosalpinx => Eileiterblutung,Eileiterhämorrhagie,Hämatosalpinx,Hämosalpinx
Hämatometra => Hämatometra
Zervixinsuffizienz => Zervixdilatation,Zervixerweiterung,Zervixinsuffizienz
Hämatokolpos => Hämatokolpos,Kryptomenorrhoe
Ovulationsblutung => Mittelblutung,Ovulationsblutung,Ovulationshämorrhagie
Mittelschmerz => Intermenstrualschmerzen,Mittelschmerzen,Ovulationsschmerzen
Dyspareunie => Dyspareunie,Koitalgie
Vaginismus => Vaginalspasmus,Vaginismus
Postmenopausenblutung => Postmenopausenblutung
Abdominalgravidität => Abdominalgravidität,Bauchhöhlengravidität,Bauchhöhlenschwangerschaft,Peritonealgravidität,Peritonealschwangerschaft
Tubargravidität => Eileiterschwangerschaft,Tubarabort,Tubargravidität,Tubenmole,Tubenschwangerschaft
Ovarialgravidität => Eierstockschwangerschaft,Ovargravidität,Ovarschwangerschaft
Schwangerschaftsödeme => Gestationsödem,Schwangerschaftshydrops,Schwangerschaftsödem
Schwangerschaftsproteinurie => Entbindungsalbuminurie,Gestationsproteinurie,Schwangerschaftsalbuminurie,Schwangerschaftsproteinurie,Wochenbettalbuminurie
Zwillingsschwangerschaft => Gemini-Gravidität,Gemini-Schwangerschaft,Zwillingsgravidität,Zwillingsschwangerschaft
Drillingsschwangerschaft => Drillingsgravidität,Drillingsschwangerschaft
Vierlingsschwangerschaft => Vierlingsgravidität,Vierlingsschwangerschaft
Polyhydramnion => Amnionhydrops,Hydramnion,Polyhydramnie,Polyhydramnion
Oligohydramnion => Oligohydramnion
Puerperalfieber => Kindbettfieber,Puerperalendometritis,Puerperalfieber,Puerperalperitonitis,Puerperalsepsis,Wochenbettfieber
Fruchtwasserembolie => Amnioninfusionssyndrom,Fruchtwasserembolie
Mikity-Wilson-Syndrom => Mikity-Wilson-Krankheit,Mikity-Wilson-Syndrom
Rötelnembryopathie => Rubeolenembryopathie,Rötelnembryopathie
Gallepfropf-Syndrom => Inspissated-bile-Syndrom
Mekoniumpfropf-Syndrom => Mekoniumpfropfsyndrom a.n.k.
Anenzephalie => Akranie,Akranius,Amyelenzephalie,Amyelenzephalus,Anenzephalie,Anenzephalus,Azephalie,Azephalus,Gehirnagenesie,Gehirnaplasie,Hemianenzephalie,Hemianenzephalus,Hemienzephalie,Hemizephalie,Hemizephalus
Kraniorhachischisis => Kraniorhachischisis
Inienzephalie => Inienzephalie,Inienzephalus
Mikrozephalie => Gehirnhypoplasie,Hydromikrozephalie,Mikrenzephalie,Mikroenzephalie,Mikrozephalus
Arrhinenzephalie => Arhinenzephalie,Arrhinenzephalie,Arrhinenzephaliesyndrom
Holoprosenzephalie-Syndrom => Holoprosenzephalie,Holoprosenzephaliesyndrom
Megalenzephalie => Megalenzephalie
Amyelie => Amyelie,Rückenmarkagenesie,Rückenmarkaplasie
Diastematomyelie => Diastematomyelie
Hydromyelie => Hydromyelie,Hydrorrhachis
Arnold-Chiari-Syndrom => Arnold-Chiari-Krankheit,Arnold-Chiari-Missbildung,Arnold-Chiari-Obstruktion,Arnold-Chiari-Syndrom
Mikrophthalmus => Augendysplasie,Augenhypoplasie,Kryptophthalmus,Mikrophthalmie,Mikrophthalmus
Makrophthalmus => Makrophthalmus,Megalophthalmus
Linsenkolobom => Linsenkolobom
Sphärophakie => Sphärophakie
Iriskolobom => Iriskolobom,Kolobom,Uvea-Kolobom-Syndrom
Makrotie => Makrotie
Mikrotie => Mikrotie,Ohrhypoplasie,Ohrmuschelhypoplasie
Makrostomie => Makrostomie
Mikrostomie => Mikrostomie
Makrocheilie => Makrocheilie
Mikrocheilie => Mikrocheilie
Vorhofisomerismus => Vorhofisomerismus
Ventrikelseptumdefekt => Herzkammerscheidewanddefekt,Herzkammerseptumanomalie,Herzventrikelseptumdefekt,Kammerscheidewanddefekt,Kammerseptumdefekt,Roger-Krankheit,Roger-Syndrom,Ventrikelseptumanomalie,Ventrikelseptumdefekt,Ventrikelseptumverlagerung
Vorhofseptumdefekt => Atrioseptaldefekt,Cossio-Syndrom,Herzvorhofseptumanomalie,Herzvorhofseptumdefekt,Lutembacher-Komplex,Lutembacher-Syndrom,Ostium-secundum-Defekt,Vorhofscheidewanddefekt,Vorhofseptumanomalie,Vorhofseptumdefekt
Fallot-Tetralogie => Fallot-Tetralogie
Pulmonalklappenatresie => Pulmonalklappenatresie
Ebstein-Anomalie => Ebstein-Anomalie,Ebstein-Herzanomalie,Ebstein-Syndrom
Dextrokardie => Dextrokardie,Herztransposition
Lävokardie => Lävokardie
Choanalatresie => Choanalatresie,Choanalfusion,Choanalstenose,Nasenlochatresie
Kehlkopfsegel => Kehlkopfsegel,Larynxsegel
Uvulaspalte => Uvulaspalte,Uvulaspaltfehlbildung,Uvulaspaltung
Ankyloglosson => Ankyloglossie,Ankyloglosson,Ankyloglossum-superius-Syndrom,Frenulumverkürzung
Schlundtasche => Hypopharynxdivertikel,Pharynxdivertikel,Rachendivertikel
Ösophagusmembran => Ösophagusmembran
Meckel-Divertikel => Meckel-Divertikel,Meckel-Dünndarmdivertikel
Hirschsprung-Krankheit => Aganglionose,Aganglionosis,Hirschsprung-Krankheit,Jirásek-Zuelzer-Wilson-Krankheit,Jirásek-Zuelzer-Wilson-Syndrom,Makrokolon
Kloakenpersistenz => Kloakenpersistenz
Choledochuszyste => Choledochuszyste
Hymenalatresie => Hymenalatresie,Hymenalplattenverschluss,Hymenalseptum,Hymenfusion
Potter-Syndrom => Potter-Fazies,Potter-Sequenz,Potter-Syndrom
Nierendysplasie => Nierendysplasie
Epispadie => Anaspadie,Epispadie,Harnröhrenspalte,Klitorisepispadie,Urethraspalte
Gesichtsasymmetrie => Gesichtsasymmetrie
Dolichozephalie => Dolichozephalie,Dolichozephalus
Plagiozephalie => Plagiozephalie,Plagiozephalus
Polysyndaktylie => Polysyndaktylie
Spalthand => Handspaltung,Spalthand
Spaltfuß => Fußspaltung,Spaltfuß
Kraniosynostose => Akrozephalie,Akrozephalus,Brachyzephalie,Brachyzephalus,Kahnschädel,Kielkopf,Kraniostenose,Kraniosynostose,Oxyzephalie,Oxyzephalus,Pyrgozephalus,Skaphozephalie,Skaphozephalus,Sphenozephalie,Spitzschädel,Trigonozephalie,Trigonozephalus,Turmschädel,Turrizephalie
Hypertelorismus => Hypertelorismus
Makrozephalie => Makrozephalie,Megalozephalie a.n.k.,Megalozephalus a.n.k.
Klippel-Feil-Syndrom => Klippel-Feil-Deformität,Klippel-Feil-Krankheit,Klippel-Feil-Syndrom
Halsrippe => Halsrippe,Halsrippenanomalie,Halsrippensyndrom
Achondrogenesie => Achondrogenesie,Hypochondrogenesie
Kurzripp-Polydaktylie-Syndrome => Jeune-Krankheit,Kurzrippen-Polydaktylie-Syndrom
Chondrodysplasia-punctata-Syndrome => Chondrodysplasia-punctata-Syndrom,Conradi-Hünermann-Krankheit,Conradi-Hünermann-Syndrom
Achondroplasie => Achondroplasie,Hypochondroplasie,Parrot-Kaufmann-Krankheit,Parrot-Krankheit,Parrot-Syndrom
Marmorknochenkrankheit => Albers-Schönberg-Krankheit,Albers-Schönberg-Syndrom,Glasknochenerkrankung,Marmorknochen,Marmorknochenkrankheit,Osteofibrose,Osteopetrosis,Osteosclerosis,Osteosklerose
Enchondromatose => Dyschondroplasie,Enchondromatose,Hemichondrodysplasie,Hemichondrodystrophie,Kast-Syndrom,Maffucci-Syndrom,Ollier-Chondrodysplasie,Ollier-Krankheit,Ollier-Syndrom,Osteochondromatose-Syndrom
Exomphalus => Exomphalus,Nabelschnurbruch,Omphalozele
Gastroschisis => Gastroschisis
Bauchdeckenaplasie-Syndrom => Bauchdeckenaplasiesyndrom
Ehlers-Danlos-Syndrom => Ehlers-Danlos-Syndrom
Anonychie => Anonychie
Antiepileptika-Embryopathie => Antiepileptikaembryopathie,Hydantoindysmorphie
Warfarin-Embryopathie => Warfarindysmorphie,Warfarinembryopathie
Marfan-Syndrom => Arachnodaktylie,Marfan-Syndrom,Spinnenfingrigkeit,Spinnengliedrigkeit
Palpitationen => Herzklopfen,Palpitationen
Epistaxis => Epistaxis,Nasenbluten,Nasenhämorrhagie,Nasenmuschelhämorrhagie,Rhinorrhagie
Hämoptoe => Bluthusten,Blutspucken,Blutsturz,Haemoptysis,Hämoptoe,Hämoptyse
Husten => Dauerhusten,Husten,Hustenreiz,Reizhusten,Tussis
Dyspnoe => Atemnot,Atemschwäche,Atmungsdistress,Belastungsdyspnoe,Dyspnoe,Hyperventilationsdyspnoe,Keuchen,Kurzatmigkeit,Lufthungergefühl,Luftnot,Orthopnoe,Ruhedyspnoe,Schnappatmung
Stridor => Stertor,Stridor
Hyperventilation => Hyperpnoe,Hyperventilation,Hyperventilationstetanie
Mundatmung => Mundatmung,Rhonchopathie,Schnarchen,Schniefen
Singultus => Schluckauf,Schlucksen,Singultus
Niesen => Niesen
Halsschmerzen => Halsschmerzen
Asphyxie => Anoxie,Anoxämie,Asphyxia,Asphyxie,Hypoxämie,Sauerstoffmangel,Scheintod
Pleuritis => Basalpleuritis,Brustfellentzündung,Pleurabelag,Pleuraentzündung,Pleuraretraktion,Pleuritis,Rippenfellentzündung
Atemstillstand => Atemstillstand,Atemversagen,Atmungsstillstand,Atmungsversagen,Herz-Lungen-Versagen
Sodbrennen => Pyrosis,Sodbrennen
Stuhlinkontinenz => Einkoten,Enkopresis,Stuhlabgang,Stuhlinkontinenz,Stuhlschmiere
Aszites => Abdomenwassersucht,Bauchwassersucht,Hydroperitoneum
Bauchdeckenspannung => Abdominalrigidität,Bauchdeckenspannung
Mundgeruch => Halitosis,Mundgeruch
Zyanose => Blausucht,Lippenzyanose,Zyanose
Blässe => Blässe,Erbleichung,Hautblässe,Livedo,Pallor
Faszikulation => Faszikulation,Zuckungen
Immobilität => Bettlägerigkeit,Immobilität,Mobilitätsbeeinträchtigung,Mobilitätseinschränkung
Tetanie => Karpopedalspasmus,Konvulsionstetanie,Krampfbereitschaft,Pseudotetanie,Spasmophilie,Tetania,Tetanie
Meningismus => Meningismus
Dysurie => Algurie,Dysurie,Strangurie
Harnverhaltung => Harnretention,Harnsperre,Harnverhaltung,Ischurie
Polyurie => Entlastungspolyurie,Harndrang,Harnflut,Hyperurese,Nykturie,Pollakisurie,Polyurie,Urina-spastica-Syndrom,Wasserdiurese
Urin-Extravasation => Harnextravasation,Harninfiltration,Urinextravasation,Urinom
Somnolenz => Benommenheit,Bewusstseinstrübung,Schläfrigkeit,Somnolenz,Vigilanzminderung
Sopor => Sopor,Stupor
Anosmie => Anosmie,Geruchssinnverlust,Hyposmie
Parosmie => Geruchstäuschung,Hyperosmie,Kakosmie,Parosmie
Parageusie => Ageusie,Dysgeusie,Geschmackssinnverlust,Parageusie
Nervosität => Nervosität
Unglücklichsein => Sorge,Unglücklichsein
Feindseligkeit => Feindseligkeit
Hyperaktivität => Hyperaktivität
Agnosie => Agnosie,Anton-Babinski-Syndrom,Astereognosie,Autotopagnosie,Pragmatagnosie,Seelenblindheit,Seelentaubheit,Stereoagnosie
Apraxie => Apraxie
Dysphonie => Dysphonie,Heiserkeit
Aphonie => Aphonie,Stimmlosigkeit,Stimmverlust
Kopfschmerz => Cephalaea,Cephalalgia,Gesichtsschmerzen,Kephalgie,Kombinationskopfschmerzen,Kopfdruck,Kopfschmerzen,Prosopalgie,Zephalgie
Senilität => Alter,Altern,Altersabbau,Altersatrophie,Altersauszehrung,Alterserschöpfung,Altersfibrose,Altersgebrechlichkeit,Altersherz,Altersinvolution,Alterskachexie,Altersschwäche,Alterstod,Altersveränderung,Presbykardie,Präsenilität,Seneszenz,Senilität,Senium,Vergreisung
Fieberkrämpfe => Fieberanfall,Fieberkrampf
Anorexie => Anorexia,Anorexie,Aphagie,Appetitlosigkeit,Appetitmangel,Appetitstörung,Appetitverlust,Dysorexie,Essunlust,Inappetenz,Magersucht
Polydipsie => Polydipsie
Polyphagie => Essattacken,Hyperalimentation,Hyperalimentationssyndrom,Hyperphagie,Polyphagie,Überernährung,Überessen,Überfütterung
Kachexie => Denutrition,Inanition,Kachexia,Kachexie,Kachexie-Syndrom a.n.k.,Pädatrophie,Säuglingsdystrophie,Tumorkachexie
Trommelschlegelfinger => Glockenklöppelfinger,Klumpfinger,Kolbenfinger,Trommelschlegelfinger,Uhrglasnägel
Glukosurie => Glukosurie,Harnzuckerausscheidung
Chylurie => Chylurie,Galakturie,Lipurie
Myoglobinurie => Myoglobinurie,Myoglobulinurie
Bilirubinurie => Bilirubinurie,Cholurie
Hämoglobinurie => Globinurie,Hämoglobinurie,Methämoglobinurie
Azetonurie => Azetonurie,Ketonurie
Lippe => Lippenplatzwunde
Schädeldachfraktur => Kalottenfraktur,Kalottentrümmerfraktur,Scheitelbeinfraktur,Schädeldachbruch,Schädeldachfraktur,Schädelkalottenbruch,Schädelkalottenfraktur,Stirnbeinfraktur,Stirnhöhlenwandbruch,Stirnhöhlenwandfraktur,Vertexfraktur
Schädelbasisfraktur => Ambossfraktur,Felsenbeinabsprengung,Felsenbeinbruch,Felsenbeinfraktur,Felsenbeinlängsbruch,Felsenbeinlängsfraktur,Felsenbeinquerbruch,Felsenbeinquerfraktur,Hinterhauptbeinfraktur,Keilbeinfraktur,Orbitadachfraktur,Schläfenbeinfraktur,Schädelbasisbruch,Schädelbasisfissur,Schädelbasisfraktur,Schädelbasisringbruch,Schädelbasisringfraktur,Schädelbasisscharnierbruch,Schädelbasisscharnierfraktur,Siebbeinfraktur
Nasenbeinfraktur => Nasenbeinbruch,Nasenbeinfraktur,Nasenfraktur,Pflugscharbeinfraktur,Vomerfraktur
Zahnfraktur => Zahnfraktur,Zahnwurzelfraktur
Kieferluxation => Kieferdiskusluxation,Kieferdislokation,Kiefergelenkluxation,Kieferknorpelluxation,Kieferluxation,Mandibuladislokation,Unterkieferdislokation
Zahnluxation => Zahnabriss,Zahndislokation,Zahnluxation
Gehirnerschütterung => Gehirnerschütterung
Skalpierungsverletzung => Skalpierungsverletzung
T1 und T2 => Brustwirbelfraktur T1,Brustwirbelfraktur T2
T3 und T4 => Brustwirbelfraktur T3,Brustwirbelfraktur T4
T5 und T6 => Brustwirbelfraktur T5,Brustwirbelfraktur T6
T7 und T8 => Brustwirbelfraktur T7,Brustwirbelfraktur T8
T9 und T10 => Brustwirbelfraktur T10,Brustwirbelfraktur T9
T11 und T12 => Brustwirbelfraktur T11,Brustwirbelfraktur T12
T1/T2 und T2/T3 => Brustwirbelluxation T1/T2,Brustwirbelluxation T2/T3
T3/T4 und T4/T5 => Brustwirbelluxation T3/T4,Brustwirbelluxation T4/T5
T5/T6 und T6/T7 => Brustwirbelluxation T5/T6,Brustwirbelluxation T6/T7
T7/T8 und T8/T9 => Brustwirbelluxation T7/T8,Brustwirbelluxation T8/T9
T9/T10 und T10/T11 => Brustwirbelluxation T10/T11,Brustwirbelluxation T9/T10
Zwerchfell => Diaphragmaeinriss,Diaphragmaverletzung
Thymus => Thymusverletzung
Brustkorbzerquetschung => Brustkorbzerquetschung,Thoraxzerquetschung
Gallenblase => Gallenblasenverletzung
Gallengang => Gallengangsverletzung
Duodenum => Duodenalverletzung
Peritoneum => Peritonealverletzung
Mesenterium => Mesenterialabriss,Mesenterialriss,Mesenterialruptur,Mesenterialverletzung
Nebenniere => Nebennierenverletzung
Prostata => Prostatatrauma,Prostataverletzung
Samenleiter => Samenleiterverletzung
Penisfraktur => Penisfraktur
Akromion => Akromionfraktur
Kopf => Humeruskopffraktur,Oberarmkopfbruch,Oberarmkopffraktur
Olekranon => Olekranonfraktur
Kopf => Radiusköpfchenfraktur
Kollum => Radiushalsfraktur
Extensionsfraktur => Colles-Fraktur
Flexionsfraktur => Barton-Fraktur,Smith-Fraktur
Schürfwunde => Daumenschrunde
Basis => Bennett-Fraktur,Os-metacarpale-I-Basisfraktur
Schürfwunde => Oberschenkelschürfwunde
Sonstige => Tibiakopffraktur,Tibiaplateaufraktur
Sonstige => Schienbeinbruch,Schienbeinfraktur,Tibiafraktur,Tibiaschaftfraktur,Unterschenkelschaftfraktur
Bimalleolarfraktur => Bimalleolarfraktur,Dupuytren-Fraktur
Trimalleolarfraktur => Trimalleolarfraktur
Prellung => Rumpfkontusion,Rumpfprellung,Rückenprellung,Wirbelsäulenprellung,WS-Prellung
Prellung => Armprellung
Prellung => Beinprellung
Schürfwunde => Abschürfung,Exkoriation,Hautabschürfung,Schürfwunde
Prellung => Blutbeule,Bluterguss,Contusio,Hautprellung a.n.k.,Hämatom,Knochenkontusion,Knochenprellung a.n.k.,Prellung,Quetschung,Quetschwunde
Sonstige => Katzenkratzer,Kratzspuren,Kratzwunde,Serom,Surfer-Knoten,Surfer-Schwielen
Heroin => Heroinintoxikation
Kokain => Kokainintoxikation
Inhalationsanästhetika => Halothanschädigung
Barbiturate => Barbituratintoxikation
Benzodiazepine => Benzodiazepinintoxikation
Äthanol => Äthanolintoxikation,Äthanolvergiftung
Benzol => Benzolvergiftung
Chloroform => Chloroformintoxikation,Chloroformvergiftung,Trichlormethanintoxikation,Trichlormethanvergiftung
Blausäure => Blausäureintoxikation,Blausäurevergiftung
Ciguatera-Fischvergiftung => Ciguatera-Fischvergiftung
Scombroid-Fischvergiftung => Scombroid-Fischvergiftung
Schlangengift => Schlangenbiss
Spinnengift => Arachnidismus,Latrodektismus-Syndrom
Hitzesynkope => Hitzekollaps,Hitzeohnmacht,Hitzesynkope
Hitzekrampf => Hitzekrampf,Hitzetetanie
Hitzeödem => Hitzeödem
Hypothermie => Hypothermie,Unterkühlung
Frostbeulen => Frostbeule,Kälte-Erythem,Pernio,Pernioerythem,Perniones
Erstickung => Erhängen,Erstickung,Erstickungstod,Strangulation
Kinetose => Autokrankheit,Bewegungskrankheit,Eisenbahnkrankheit,Karussellkrankheit,Kinetose,Luftkrankheit,Reisekrankheit,Schaukelbewegungskrankheit,Seekrankheit
Lungentransplantat => Lungentransplantatabstoßung,Lungentransplantatversagen
Pankreastransplantat => Pankreastransplantatabstoßung,Pankreastransplantatversagen
Laboruntersuchung => Antibiogramm,Antikörpersuchtest,Blutgruppenbestimmung,Exfoliativzytodiagnostik,Laborparameteruntersuchung,Laboruntersuchung
Immunprophylaxe => Immunglobulinprophylaxe,Immunprophylaxe
Sterilisierung => Sterilisationsberatung,Sterilisationswunsch,Sterilisierung,Sterilisierungswunsch,Tubenligatur,Tubensterilisation,Vasektomie,Vasektomiewunsch
In-vitro-Fertilisation => Eizellenimplantation,Eizellentnahme,Embryotransfer,Gametentransfer,In-vitro-Fertilisation
Strahlentherapie-Sitzung => Bestrahlungstherapie,Radiotherapiesitzung,Strahlentherapiesitzung
Palliativbehandlung => Palliativbehandlung
Apherese => Apherese
Opiatsubstitution => Drogensubstitution,Methadonsubstitution,Opiatsubstitution
Vollblutspender => Blutspender
Stammzellenspender => Stammzellenspender
Hautspender => Hautspender
Knochenspender => Knochenspender
Knochenmarkspender => Knochenmarkspender
Nierenspender => Nierenspender
Korneaspender => Hornhautspender,Korneaspender
Leberspender => Leberspender
Herzspender => Herzspender
